10 +=
.......o.o
..o...oo..
..o....o..
......oo..
...o......
o......o.o
.......oo.
oo.o.o....
.o........
ooo.o..o.o